після того, як	наступний	наступний	наступний	майбутній
залишитися	залишаються	затриматись	продовжити	проживати
нормалізуватися	стандартизувати	регулювати	пристосуватися
або	альтернативно	інакше
з	поряд з	у супроводі
ініціація	початок	початок	початок	ініціювати	починається
знайдено	виявлено	розташований	створено
інакше	інший	додатковий	додатково	Ще один.	інший	альтернатива	різний
зв'язок	комунікація	дотик	контакт	ручка	відчувати	сенс	досвід	Дивіться.	спостерігати	вид	сприймати	увага	фокус	повідомлення	концентрація	центр	хаб	середній	Поглянь.	погляд
дата	зустріч	календарний день	час	зустріч	залучення	запланований час
останній	останні	найновіший	сучасний
з	що належить	що стосуються
змінено	змінений	модифікований	перетворений
кишечник	кишечник	нутро	двокрапка
допуск	в'їзд	прийняття	сповідь
про	щодо	щодо	пов'язані з
принести	нести	дайте	забезпечити	пропозиція	доставляти	візьміть	хапай	отримати	отримати	отримати	придбати
шкарпетки	панчішно-шкарпеткові вироби	взуття
багатий	заможний	заможний	рясно
днів	періоди	часові рамки
Знову	ще раз	наново	неодноразово
черевна порожнина	живіт	шлунок	тулуб
робота	праця	робота	завдання
розглянутий	зважали на те.	вважається.	оцінений
за	призначений для	від імені
рух	рух	активність	зміна	мобільність	локомоція
Іди.	від'їжджати	піти	рухайся
лихоманка	висока температура	пірексія
зустрічі	зустрічі	заручини	графіки
проносне	очисний засіб	пом'якшувач випорожнень
нормальний	звичайний	стандартний	типовий
містить	включає	тримає	охоплює
вранці.	існують	бути	може	вміти	здатний
огидно.	огидно.	огидний	мерзенний
половинки	деталі	сегменти	підрозділи
колоноскопія	обстеження кишечника	перевірка товстої кишки
потреби	вимоги	предмети першої необхідності	вимоги
до	до	в
як	подібно до	на кшталт	насолоджуватися
табурет	крісло	кал	екскременти	табуретки	місць
хвороба	хвороба	хвороба	нездужання
ясно	прозорий	очевидний	виразний	прозорі	ясно.
і	також
Ходімо.	приїжджають	підхід	охоплення
назовні.	зовнішній	геть.	назовні
йдучи	мандрівний	від'їжджає	перебіг
повернення	Повертайся.	повернутися назад	повернутися
додаток	доповнення	покращення	доповнення
мішок	мішок	мішечок	контейнер
їстівні продукти	харчування	прожиток	дієта	режим	план харчування	їжа	їжа	трапеза	тарілка	харчування	кухня
рідини	рідини	напої	напої	прохолодні напої
пацієнт	клієнт	страждати
повинен	повинен був би	повинен	повинен
що	там.	це	ці	ці	це	вони	їх
поганий	бідний	негативний	неприємний
ванна кімната	вбиральня	вбиральня	туалет
підло.	означають	припускають	намірятися
жир	надмірна вага	жирний	масивний.
беручи	еквайринг	отримання	використовуючи
зміна	змінювати	змінити	трансформуватися
Привіт.	Привіт.	привітання	привітання
питання	запити	запити	допити
розмова	говорити	розмовляти	чат
потреба	вимагати	потребують	попит	хочу	бажання	бажання
робить	виконує	дії
сертифікати	документи	повноваження	кваліфікація
справді	справді	щиро	Взагалі-то.
волокно	волокно	харчові волокна
платити	компенсувати	заспокоїтися	прибутковий
якщо	у випадку, якщо	за умови, що
ліки	наркотики	рецепти	лікування
воля	повинен	мають намір	поїдемо до
на	на	за адресою	активний
блювота	блювати.	відригнути	блювота
все ще	нерухомо.	спокій	поки що.
проносні засоби	очисні засоби	пом'якшувачі випорожнень
одного разу	один раз	раніше
часто	часто	регулярно	Зазвичай
іві	У мене є
разів	екземплярів	випадки	моменти	приклади	зразки	кейси
нічого	Нічого.	нуль	нуль
овочі	зелень	виробляти	овочі
значення	принципи	переконання	стандарти
насіння	ядро	зерно	піп
коли	о котрій годині	під час якого
може	може	міг би	можливо.
Знаю.	розумію.	розпізнати	знати про
додому	будинок	місце проживання	місце проживання
спорт	легка атлетика	ігри	фізичні навантаження
з тих пір, як	тому що	як	з того часу, як	як
не треба	не треба
шлях	метод	шлях	процедура	процес	операція
Ну, добре.	добре	здоровий	Гаразд.	задовільно	Гаразд.	Гаразд.	дозволено	дозволено	уповноважений	прийнятний
жахливо.	жахливо.	жахливо.	жахливо.	жахливо.
обидва	ті двоє	кожен з двох
біль	страждання	болить.	дискомфорт	занепокоєння	лихо	боляче	поранення	пошкодження	рана
низький	зменшений	мінімальний	невеликий
що містить	в тому числі	проведення	вкладаючи
відвідувати	брати участь	бути присутнім	піти до
Зараз.	в даний час	в даний час	на даний момент
страви	посуд	застілля	курси
приклад	приклад	зразок	модель
до тих пір, поки	до	до того, як	до тих пір, поки	до того, як	попередній	раніше
кровоточити	крововилив	сочиться.	витік
лікар	лікар	медик	цілитель
відбуваються	трапляються	відбуваються	виникають	з'ясувалося.
ліки	наркотик	лікування	засіб	рішення	відповідь	дозвіл
мене	I	мій	Я сам.
клініка	медичний центр	практика	медичний заклад
заходи	кроки	дії	процедури
високий	підвищений	високий	збільшився	піднято	доповнено	розширений
Двічі	двічі	подвійний
поживні речовини	дієтично	з точки зору харчування
алкоголь	етанол	духи	випивка
дякую	цінувати	висловити подяку	визнати
дякую	вдячність	вдячність	подяки
де	місцезнаходження	місце	позиція
скасувати	анулювати	відкликати	припинити
питання	запит	запит	зонд
привід	працювати	бичок	рушій
уникати	ухилятися	триматися подалі від	ухилятися
робити	виконувати	виконати	здійснювати
обстеження	перевірка	оцінка	перевірка
підготуватися	приготуйтеся	влаштувати	план
кілька	Кілька	різний	множинний
твої	ти є.
насіння	ядра	зерна	ями
випити	напій	рідина	прохолодні напої	рідина	водний
"У нас тут є	a
рухи	рухи	зсуви	діяльність
діарея	рідкі випорожнення	часті випорожнення	діарея
дієтичний	поживний	пов'язаний з їжею
закінчено	завершено	Готово.	укладено
в	в межах	всередині	під час
симптоми	знаки	індикатори	прояви
довгий	розширений	довгий	тривалий
кров	плазма	гемоглобін	життєва рідина
все	всі речі	цілий	всі	будь-який	деякі	що б там не було.	неважливо.	що завгодно.	щось	пункт	об'єкт	річ.	продукт
мають	мав	має	володіти	тримати	власний
платять	компенсуючий	приносящий прибуток	заселення
роздутий	набряклий	розтягнутий	роздутий
тож	таким чином	тому	отже
це	був
що	який
трапляється	відбувається	відбувається	виникає	приходить	приїжджає	з'являється
вправа	спорт	фізична активність	тренування	навчання
здібний	здібний	компетентний	досвідчений
почалося	розпочато	розпочато	розпочато
чому	причина	тому що	мета
теплий	з підігрівом	гарячий	затишна
падає	краплі.	спускається	руйнується.
під	під	нижче	під
кольоровий	кольорові	тонований	пофарбований	пігментований	темний	заплямований
їсти	споживати	проковтнути
смаки	ароматизатори	приправи	піднебіння
завтра	наступного дня	наступного дня
1-й	спершу	початковий
2-й	другий
1	один	неодружений	окрема особа	самотній
3	три