verfahren	begleitet von	mit	schritte	nach	maßnahmen	aus	erwerb von	aktionen	einschließen.	prozess	nachfolgend	reisen	kommende	weg	beschaffung von	unter	außerhalb	pfad	nächste	betrieb	aktiv	auf	abreise	methode	weiterführend	extern	neben	einschließlich
verweilen	bleiben	wohnhaft	weiter
regeln	einstellen.	normalisieren	standardisieren
ein paar	eine andere	zusätzlich	einer mehr	oder	verschiedene	sonst	ansonsten	andere	mehrere	alternativ	extra
einleiten.	beginnen	anfang	start	eröffnungsfeier	einleitung
gegründet	gefunden	ort	standort	wobei	position	entdeckt
achtung	wahrnehmen	fühlen	mitte	beobachten.	siehe	sinn	erleben	konzentration	berühren.	hinweis	kommunikation	griff	bewertung	blick	verbindung	nabe	prüfung	kontakt	zentrum	inspektion	fokus
kalendertag	termine	datum	ernennung	geplanter zeitpunkt	zeitpläne	engagements	treffen	verlobung	zeit
neueste	aktuell	am aktuellsten
von	zugehörig zu	bezug nehmend auf
geänderte	geändert	umgewandelt
darm	dickdarm
beichte	zulassung	akzeptanz	eintrag
betreffend	in	zu	während	über	verwandt mit	innerhalb
tragen	bekommen.	erwerben	geben.	angebot	liefern	anbieten.	erhalten	nehmen sie	bringen	greifen
footgear	socken	strumpfwaren
reichlich	wohlhabend	reich
zeitrahmen	zeiträume	tage
wieder	neu	wiederholt	noch einmal
bauch	magen	unterleib	torso
aufgabe	arbeit	job
denn	ähnlich wie	bewertet	aus der zeit	betrachtet	als	genießen sie	wie	seit	gleichbedeutend mit
bestimmt für	im namen von	für
antrag	lokomotion	mobilität	tätigkeit	schicht	bewegung
abreisen	umziehen	gehen.	verlassen
pyrexie	fieber	hohe temperatur
abführmittel	stuhlaufweichmacher
typisch	standard	normal	üblich
enthält	hält	umfasst
am	können	sein	fähig zu	kann	existieren
rebellisch	abstoßend	ekelhaft	abscheulich
segmente	teile	hälften	abteilungen
koloskopie	dickdarm-check	darmspiegelung
braucht	anforderungen	fordert	notwendigkeiten
sitze	exkremente	hocker	stuhl	fäkalien
krankheit	unwohlsein
deutlich	luzide	durchsichtige	klar	offensichtlich	transparent
auch	und
erreichen.	anfahrt	ankommen	kommen
zurückkommen	zurückkehren	return	zurückgehen
ergänzen	ergänzung	zusatz	erweiterung
tasche	beutel	sack	container
esswaren	regime	küche	ernährung	unterhalt	gericht	lebensmittelbezogen	ernährungsplan	nahrung	mahlzeit	lebensmittel	diätetik	gastmahl	diät
erfrischungen	flüssigkeiten	getränke
kunde	betroffene	patient
sollte	muss
sie	was	es	diese	dass	dort	a	die
arm	schlecht	unangenehm	negativ
badezimmer	toilette
beabsichtigen	implizieren	soll	mittlere	wird	gehen	bedeuten.
korpulent	fett	übergewicht
umwandeln	ändern.	ändern
hallo	anrede	grüße
verhöre	fragen	anfragen	abfragen
chat	sprechen	konvers
erfordern	wunsch	wollen	brauchen	nachfrage
tut	handelt	führt  aus.
qualifikationen	dokumente	zertifikate	berechtigungsnachweise
wirklich	eigentlich
ballaststoffe	faser
bezahlen.	regeln.	entlohnen	kompensieren
vorausgesetzt, dass	im falle	wenn	während derer	zu welchem zeitpunkt
lösung	abhilfe	verschreibungen	medikamente	behandlung	behandlungen	entschließung	antwort	droge	drogen
sich übergeben	erbrechen	kotzen
dennoch	immer noch	bewegungslos	ruhig
einmalig	einmal	zuvor
regelmäßig	häufig	oft	in der regel
ich habe	ive
instanzen	mal	beispiele	proben	fälle	vorkommnisse	momente
null	nichts
gemüse	grünzeug	produzieren	gemüsesorten
überzeugungen	grundsätze	werte	normen
kernel	körner	getreide	gruben	pip	samen	kerne
mai	könnte	vielleicht
verstehen.	beachten	erkennen	wissen
domizil	haus	aufenthalt	startseite
workout	körperliche aktivitäten	ausbildung	sport	körperliche aktivität	leichtathletik	spiele	übung
gesund	zufriedenstellend	fein	autorisiert	akzeptabel	gut	ok	erlaubt	okay	zugelassen	in ordnung
entsetzlich	schrecklich	furchtbar
jeder der beiden	beide	die beiden
leiden	verletzen	notruf	unannehmlichkeiten	verletzt	schaden	wunde	unbehagen	schmerzen
niedrig	minimal	reduziert	klein
teilnehmen	besuchen sie	gehen zu	vorhanden sein
zu diesem zeitpunkt	derzeit	zurzeit	jetzt
mahlzeiten	feste	gerichte	kurse
modell	beispiel	instanz	muster
vorhergehende	bis zu	früher	vor	bis
leck	triefen.	bluten	hämorrhagie
doktor	sanitäter	heiler	arzt
geschehen	auftreten	entstehen	sich abspielen	transpirieren
ich	i	meine	mich
praxis	gesundheitseinrichtung	klinik	medizinisches zentrum
augmented	langatmig	erweitert	hoch	verlängerte	groß	lang	erhöht
zwei mal	zweimal	doppelt
diätetisch	ernährungsphysiologisch	in bezug auf die ernährung
ethanol	alkohol	schnaps	spirituosen
anerkennen.	schätzen	danksagungen	dankbarkeit ausdrücken	dankbarkeit	wertschätzung	danke
kündigen	widerrufen	aufheben.	beenden.
abfrage	anfrage	frage	sonde
treiben	antrieb	betreiben.	lenken
vermeiden	meiden	ausweichen	dodge
tun	durchführen	ausführen.	vollziehen
plan	vorbereiten	arrangieren.	sich vorbereiten
erfrischung	flüssig	trinken	wässrig	flüssigkeit	getränk
aktivitäten	bewegungen	verschiebungen	anträge
diarrhöe	häufiger stuhlgang	lose stühle
fertig	abgeschlossen
zeichen	indikatoren	symptome	manifestationen
blut	lebenswichtige flüssigkeit	hämoglobin	plasma
etwas	das ganze	alles	alle dinge	welche auch immer	was auch immer	artikel	alle	sache	produkt	objekt	jede	einige
hatte	besitzen	halten	eigene	haben	hat
kompensation	entlohnung	bezahlen	abrechnung
aufgeblasen	geschwollen	aufgebläht
daher	also	folglich
ist	war
erfolgt	trifft ein	erscheint	findet statt	ergibt sich	kommt	geschieht
fähig	tüchtig	kompetent
gestartet	begonnen	initiiert
zweck	grund	verursachen	warum
warm	beheizt	heiß	gemütlich
kollabiert	abstieg	tropfen	fällt
farbig	eingefärbt	getönte	dunkel	pigmentiert	gebeizt
aufnehmen.	verbrauchen	essen
genießt	schmeckt	gaumen	geschmäcker
nächster tag	folgetag	morgen
erste	anfänglich	1.
2.	zweite
einzeln	einsamkeit	individuell	eine	1
3	drei
