sonraki	yaklaşıyor	sonra	aşağıdaki
zencefil	kal	ikamet etmek	kalır	devam et
hazırlamak	plan	hazir ol	normalleştirmek	düzenlemek	ayarlamak	standartlaştırmak
veya	aksi takdirde	alternatif olarak
ile	eşlik eden	yanında
başla	başlatmak	kadar	başlatma	ta ki	başlangıç	daha önce	başlangiç	bir kez	önce	1.	önceki
bulundu	keşfedildi	bulunan	kurulmuş
bariz	berrak	başka bir	ekstra	farklı	bir tane daha	ilave	başka	temiz	şeffaf	diğer	alternatif	transparan
deneyim	merkez	görünüm	bağlantı	bak	i̇letişim	di̇kkat	sap	bi̇ldi̇ri̇m	duyu	bkz.	hissetmek	gözlemlemek	gövde	karın	konsantrasyon	mide	bakış	göbek	dokunmak	odaklanma	algılayıcı	orta	iletişim
randevu	zaman	planlanmış zaman	nişanlılık	toplantı	takvim günü	tarih
en yeni	güncel	en son
ile ilgili	.	ait	ilgili	hakkında
değiştirilmiş	değişti	dönüştürüldü	değişmiş
bağırsak	kolon
gıda ile ilgili	yemek	yenilebilir şeyler	diyet	rizik	mutfak	reji̇m	repast	giriş	beslenme	çanak	tüketmek	i̇tiraf	yeme planı	kabul
kapmak	al	ver	taşımak	olsun	teslim et	teklif	almak	elde etmek	getirmek	sağlamak	alarak	edinme	edinmek	kullanarak
çorap	çoraplar	ayak gi̇yi̇mi̇
bol miktarda	varlıklı	zengin
dönemler	günler	zaman dilimleri
tekrar	yeniden	bir kez daha	tekrar tekrar
görev	iş	emek
sayılır	kabul edildi	dikkate alındı	değerlendirildi
doğru	içine	adına	için tasarlanmıştır	için
aktivite	hareket	hareketlilik	vardiya	lokomosyon
hareket et	ayrılmak	git
pyrexia	ateş	yüksek sıcaklık
randevular	toplantılar	angajmanlar	programlari
müshil	dışkı yumuşatıcı
tipik	normal	standart	olağan
içerir	şunları içerir	tutar	kapsar
yetkin	var olmak	belki de	olabilir	yapabiliyor olmak	mümkün	am	mayıs	olmak	yetenekli
i̇ğrenç	isyan	itici	aşağılık
segmentler	yarımlar	bölümler	parçalar
kolonoskopi	kolon kontrolü	bağırsak muayenesi
gerekli̇li̇kler	ihtiyaçlar	gereksinimler	talepler
keyfini çıkarın	benzer	gibi
dışkı	tabure	tabureler	sandalye	koltuklar
halsizlik	hastalık
a	ayrıca	ve
yaklaşım	varmak	ulaşmak	gel
dışarı	uzakta	dışarıda	dış
seyahat etmek	devam ediyor	ayrılıyor	gidiyor
dönüş	geri gel.	geri dön
ek olarak	ek	geli̇şti̇rme	tamamlayıcı
çanta	çuval	kese	konteyner
sıvılar	i̇kramlar	i̇çecekler
acı çeken	müşteri	hasta
ihtiyacı var	gerekir	yapmalısın
bu	şunlar	bunlar	onlar	orada	o	oldu
nahoş	kötü	negatif	fakir
tuvalet	lavabo	banyo
niyet	signify	dolaylı olarak	ortalama
fazla kilolu	şişman	yağlı
dönüştürmek	değişim	değiştir	alter
merhaba	selamlama	selamlar
sorgulamalar	sorular	sorgular
converse	sohbet	konuşmak
keşke	gereklilik	istiyorum	talep	gerektirir	arzu	ihtiyaç
gerçekleştirir	adımlar	yok	önlemler	prosedürler	eylemler
belgeler	ki̇mli̇k bi̇lgi̇leri̇	nitelikler	sertifikalar
aslında	gerçekten
diyet lifi	lif
yerleşmek	öde	telafi etmek	ücretlendirmek
durumda	şu şartla	eğer
i̇laçlar	uyuşturucu	tedaviler	reçeteler
olacak	gideceğim.	niyet etmek	olacaktır
üzerinde	üzerine	at	aktif
kusmuk	kusmak
henüz	hala	hareketsiz	sakin
laksatifler	purgatifler	dışkı yumuşatıcılar
düzenli olarak	sık sık	genellikle
ben varım.	ive
olaylar	davalar	zamanlar	anlar	örnekler
hiçbir şey	naught	boş	sıfır
sebzeler	üretmek	yeşillikler
ilkeleri	standartlar	inançlar	değerler
tane	pip	çekirdek	tohum
ne zaman	bu sırada	saat kaçta
tanımak	farkında olmak	biliyorum	anlamak
ikamet	ev	ikametgah
spor	fiziksel aktivite	fi̇zi̇ksel akti̇vi̇teler	eği̇ti̇m	oyunlar	egzersiz	atleti̇zm
neden	çünkü	beri	amaç	nasıl	sebep	o zamandan beri	olarak
dont	yapmayın
yol	prosedür	süreç	operasyon	yöntem
yetkili	ince	tatmin edici	tamam.	kabul edilebilir	izin verildi	i̇zi̇n veri̇ldi̇	iyi	sağlıklı
korkunç	dehşet verici
iki	her ikisi de
huzursuzluk	rahatsızlık	yaralamak	sıkıntı	incinmiş	yara	acı çekmek	ağrı	hasar	acı
düşük	minimal	küçük	azaltılmış
içeren	dahil olmak üzere	tutma	çevreleyen
şuraya git	katılmak	mevcut olmak
şimdi	şu anda
yemekler	kurslar	zi̇yafetler	bulaşıklar
örnek	model
kanama	sizinti	sızıntı
şifacı	doktor	hekim
yer almak	oluşur	olur	ortaya çıkmak	görünür	geliyor	meydana gelir	geldi	ortaya çıkar	gerçekleşir
çare	i̇laç	tedavi	çözünürlük	çözüm	cevap
ben	i	benim	kendim
klinik	tıp merkezi	uygulama	sağlık tesisi
geliştirilmiş	artırılmış	arttı	uzun boylu	yüksek	yükseltilmiş
iki kez	çift
besinsel olarak	beslenme açısından	diyet olarak
etanol	sıvı	alkol	ruhlar	sulu	içki	içecek	akışkan	tazeleme
takdir etmek	minnettarlığınızı ifade edin	teşekkür ederim	kabul etmek
minnettarlık	takdir	teşekkürler
pozisyon	konum	yer	nerede
sonlandırmak	iptal	iptal etmek	iptal et
soruşturma	sorgu	soru	sonda
yönlendirmek	itmek	işletmek	sürücü
uzak durun	kaçmak	kaçının	dodge
gerçekleştirmek	yap	yürütmek
değerlendirme	kontrol et	deneti̇m	muayene
birkaç	çoklu	çeşitli
tohumlar	çukurlar	tahıllar	çekirdekler
hareketleri	hareketler	faali̇yetler	vardiyalar
i̇shal	sık bağırsak hareketleri	gevşek dışkı
tamamlandı	bitmiş	sonuçlandı	bitti
içeride	sırasında	içinde
göstergeler	tezahürler	semptomlar	işaretler
genişletilmiş	uzamış	uzun
yaşamsal sıvı	plazma	kan	hemoglobin
öğe	hepsi	bir şey	herhangi bir şey	bazı	şey	her şey	herhangi bir	hangisi	bütün	ne olursa olsun	ürün	nesne
var	tutun	kendi	sahip olmak	vardı
ücretlendirme	telafi edici	ödeme	yerleşme
şişirilmiş	şişmiş
bu nedenle	yani	sonuç olarak	böylece
hangi	ne
başladı	başlatıldı
rahat	sıcak	ısıtılmış
çöküyor	iner	damlalar	düşüyor
altında	aşağıda
boyalı	karanlık	pigmentli	lekeli	renkli
tatlar	damaklar
ertesi gün	yarın
2'nci	ikinci
tek	yalnız	bir	bireysel	1
3	üç
